++++++++++++++++++++++++++++++++++++++++++++++++++++++++++++
+                        A                                 +
+                        a                                 +
+                                                          +
+                                                          +
+                                                          +
+                                                          +
+                                                          +
+                                                          +
+                                                          +
+                                                          +
+                                                          +
+                                                          +
+0                                                         +
++++++++++++++++++++++++++++++++++++++++++++++++++++++++++++
