+++++++++++++
+0          +
++++++++++  +
+           +
++++++++++  +
++++++++++  +
+           +
++++++++++  +
+           +
++++++++++  +
+           +
++++++++++  +
+a         A+
+++++++++++++